7 6
. . # # # # #
. . # b . . #
# # # d d d #
# . k . . . #
# # # . . . #
. . # # # # #
. . . . . . .
. . . . b . .
. . . . . . .
. p . . b3 . .
. . . . . . .
. . . . . . .