7 5
. # # # # # #
# # b i . . #
# . . i . . #
# # # . . # #
. . # # # # .
. . . . . . .
. . . . . . .
. p b . . . .
. . . . . . .
. . . . . . .