7 7
. . # # # . .
. . # b # . .
# # # . # # #
# b . . . b #
# # # . # # #
. . # b # . .
. . # # # . .
. . . . . . .
. . . . . . .
. . . b . . .
. . b p b . .
. . . b . . .
. . . . . . .
. . . . . . .