7 6
. # # # . . .
. # . # # . .
# # . . # # #
# . . . . b5 #
# # # . # # #
. . # # # . .
. . . . . . .
. . . . . . .
. . b3 . . . .
. p b3 . b5 . .
. . . . . . .
. . . . . . .
