7 6
. # # # . . .
. # . # # . .
# # . . # # #
# . . . . b #
# # # . # # #
. . # # # . .
. . . . . . .
. . . . . . .
. . b2 . . . .
. p b2 . b . .
. . . . . . .
. . . . . . .
