9 3
# # # # # # # # #
# . p # p . . b #
# # # # # # # # #
. . . . . . . . .
. p . . . . b . .
. . . . . . . . .