9 6
. . . . # # # # #
. . . . # b . . #
# # # # # # # d #
# . . . . k k k #
# . . . . . . . #
# # # # # # # # #
. . . . . . . . .
. . . . . . b . .
. . . . . . . . .
. . b3 . b3 . . . .
. p . . . . . . .
. . . . . . . . .