7 5
# # # # # # #
# . . . . . #
# . . . . . #
# b1 b2 b3 b4 b5 #
# # # # # # #
. . . . . . .
. p . . . . .
. b1 b2 b3 b4 b5 .
. . . . . . .
. . . . . . .