16 9
# # # # # # # # # # # # # # # #
# . . . . . . . . . . . . . . #
# . . . b1 . . . . . . . . . . #
# . . . b2 . . . . . . . . . . #
# . . . . . . i i i . . . . . #
# . . . . . . . . . . . . . . #
# . . . . . . . . . . . . . . #
# . . . . . . . . . . . . . . #
# # # # # # # # # # # # # # # #
. . . . . . . . . . . . . . . .
. p . . . . . . . . . . . . . .
. . b1 . . . . . . . . . . . . .
. . b2 . . . . . . . . . . . . .
. . . . b . . . . . . . . . . .
. . . . . . . . . . . . . . . .
. . . . . b3 b3 b3 . . . . . . . .
. . . . . . . . . . . . . . . .
. . . . . . . . . . . . . . . .