16 9
# # # # # # # # # # # # # # # #
# . . . . . . . . . . . . . . #
# . . . b1 . . . . . . . . . . #
# . . . b2 . . . . . . . . . . #
# . . . . . . . . . . . . . . #
# . . . . . . . . . . . . . . #
# . . . . . . . . . . . . . . #
# . . . . . . . . . . . . . . #
# # # # # # # # # # # # # # # #
. . . . . . . . . . . . . . . .
. p . . . . . . . . . . . . . .
. . b1 . . . . . . . . . . . . .
. . b2 . . . . . . . . . . . . .
. . . . . . . . . . . . . . . .
. . . . . . . . . . . . . . . .
. . . . . b3 b3 b3 . . . . . . . .
. . . . . . . . . . . . . . . .
. . . . . . . . . . . . . . . .