6 6
. . # # # #
# # # . . #
# . . r5 . #
# . . r3 . #
# # . . b #
. # # # # #
. . . . . .
. . . . p .
. . . . . .
. . b . . .
. . . . . .
. . . . . .