7 6
. # # # . . .
# # b # # # #
# . f f . . #
# # . . . . #
. # . . . . #
. # # # # # #
. . . . . . .
. . . . . . .
. p . . . . .
. . b b2 b2 . .
. . . . . . .
. . . . . . .