7 6
. . # # # # #
# # # p # b #
# . . . # . #
# # . # # . #
. # . . . p #
. # # # # # #
. . . . . . .
. . . . . . .
. p b2 . . b .
. . . . . . .
. . . . . . .
. . . . . . .