9 7
# # # # . # # # .
# . . # . # b # .
# . . # # # . # #
# . . p # . p . #
# . . # # # . # #
# . . # . # # # .
# # # # . . . . .
. . . . . . . . .
. p . . . . . . .
. . b2 . . . b . .
. . b2 . . . . . .
. . b2 . . . . . .
. . . . . . . . .
. . . . . . . . .