7 5
# # # # # # #
# . . . . . #
# . . . . . #
# b0 b1 b2 b3 b4 #
# # # # # # #
. . . . . . .
. p . . . . .
. b0 b1 b2 b3 b4 .
. . . . . . .
. . . . . . .